R 500 500

EA ./images/eagle.xpm
NO ./images/bluestone.xpm
SO ./images/mossystone.xpm
WE ./images/colorstone.xpm

S ./images/barrel.xpm

F 0,0,0

C 130,130,130

1111111111111111111111111
1000000000110000000000001
1011000001110000000000001
100100000000000000000000111111111
111111111011000001110000000000001
100000000011000001110111111111111
11112111111111011100000010001
11112111111111011101010010001
11002000110101011100000010001
10000000000000001100000000001
10002000W0000011010100100011
110000111010101111101111000111
11110111 1110101 101111010001
11111111 1111111 111111111111
