R 500 500

NO ./textures/colorstone.xpm
SO ./textures/eagle.xpm
WE ./textures/purplestone.xpm
EA ./textures/greystone.xpm

S ./textures/barrel.xpm

C 0 ,5,255
F 0, 0, 0

   111111111111111111
  111111110002000001
   102000000000111111
    1111111100E000001
            1000202001
            1200200001
           11000000001
          1111111111111
