
EA ./images/east.xpm
R 1000 1000
NO ./images/graystone.xpm
SO ./images/mossystone.xpm
WE ./images/colorstone.xpm

S ./images/barrel.xpm

F 150,150,150

C 30,30,             30

11111
12001
10E21
12021
11111


